5 7 6 8 5 4 5 8 6 7 8 6 5 8 4 4 6 7 8 5
4 2 1 3 0 3 1 0 2 1 0 3 2 0 1 1 3 0 0 6
8 0 2 1 0 0 3 2 1 3 1 3 0 3 2 1 0 2 3 4
6 2 2 0 1 1 2 1 1 1 2 0 3 1 3 3 1 1 3 8
7 2 3 2 0 0 3 2 1 1 1 3 0 3 0 0 0 3 2 5
8 1 0 3 3 0 3 1 2 2 0 3 0 2 0 1 1 1 3 4
5 2 1 0 1 3 0 0 1 0 3 1 1 1 1 0 1 2 0 6
4 3 0 1 1 0 0 2 1 3 1 3 1 2 2 1 0 2 3 8
7 3 3 0 3 2 3 2 2 0 1 0 0 1 1 3 0 0 1 5
8 2 0 2 2 1 0 0 0 3 3 3 1 1 1 1 1 3 1 7
4 6 3 8 4 3 2 2 1 3 0 3 3 1 3 2 0 0 0 6
7 3 2 2 5 3 3 2 2 2 0 1 0 3 0 0 2 1 2 8
4 0 1 3 7 1 3 2 0 2 1 0 0 0 3 0 1 1 3 6
8 3 0 0 5 2 1 0 3 2 1 3 0 1 3 1 2 3 0 7
5 7 5 4 7 5 8 4 6 2 8 7 6 8 5 7 4 7 4 6
6 2 1 4 0 1 2 0 2 3 0 3 2 7 1 0 1 2 1 5
4 0 1 5 3 1 0 2 2 2 3 0 0 8 0 1 0 0 2 6
8 2 3 7 1 2 2 1 0 2 3 0 1 6 2 1 3 2 3 5
7 2 0 8 3 3 0 0 1 3 1 2 0 8 5 4 3 6 5 4
6 0 2 7 3 1 2 1 3 2 0 1 0 0 1 1 0 0 3 7
5 1 3 6 0 1 1 0 1 2 1 3 2 1 1 2 1 2 3 4
8 2 1 5 3 3 0 3 1 1 0 3 2 3 2 2 1 0 2 6
7 1 1 4 0 0 3 3 0 0 1 3 1 1 1 2 0 1 1 5
4 3 3 1 2 0 3 0 2 1 2 3 2 1 1 1 3 0 1 8
6 3 0 8 3 3 1 2 2 1 1 3 1 1 1 3 3 2 3 7
8 3 1 7 0 2 1 1 2 0 1 2 1 0 2 0 1 2 0 6
4 0 2 5 1 3 3 0 2 3 3 1 3 0 2 1 1 3 1 8
7 2 1 8 0 2 0 0 3 0 2 0 2 1 1 3 3 2 0 6
6 7 5 8 6 8 6 5 7 0 7 8 7 5 5 6 7 5 4 4
4 3 1 0 0 3 3 3 0 3 0 3 0 2 1 3 3 2 2 8
6 0 2 3 1 0 1 3 2 1 1 2 2 1 2 3 0 3 2 5
8 1 1 2 3 2 2 2 0 1 0 1 3 3 2 1 2 1 3 4
4 3 1 2 0 0 1 1 3 1 0 2 0 1 2 1 0 3 1 7
7 2 2 1 0 2 0 1 0 0 2 1 3 0 3 0 3 2 3 8
5 1 1 2 2 0 2 2 2 1 2 0 3 0 1 2 3 2 3 4
4 0 3 2 0 3 2 3 3 2 1 0 2 3 1 1 0 1 2 7
8 1 2 2 1 3 3 0 3 1 1 0 0 2 1 2 3 1 1 6
6 0 0 0 0 1 2 3 0 1 0 1 0 1 3 3 0 1 1 4
8 1 3 3 0 2 0 0 3 2 2 3 0 1 0 0 2 0 1 7
5 7 8 5 7 4 6 6 7 8 7 6 7 5 8 7 4 6 8 5